aaa	K
aag	K
aat	N
aac	N
aga	R
agg	R
agt	S
agc	S
ata	I
atg	M
att	I
atc	I
aca	T
acg	T
act	T
acc	T
gaa	E
gag	E
gat	D
gac	D
gga	G
ggg	G
ggt	G
ggc	G
gta	V
gtg	V
gtt	V
gtc	V
gca	A
gcg	A
gct	A
gcc	A
taa	-
tag	-
tat	Y
tac	Y
tga	-
tgg	W
tgt	C
tgc	C
tta	L
ttg	L
ttt	F
ttc	F
tca	S
tcg	S
tct	S
tcc	S
caa	Q
cag	Q
cat	H
cac	H
cga	R
cgg	R
cgt	R
cgc	R
cta	L
ctg	L
ctt	L
ctc	L
cca	P
ccg	P
cct	P
ccc	P
